>Top
1111111111111111
0110011111100000
0000001111000000
0000000000000000
0000000000000000
0000000000000000
0000000000000000
0000000000000000
0000000000000000
-
1111111111111111
1001100000000001
0001100000000100
0001111111000111
0001111111000000
0000000011111000
0000011011110000
0001111000000000
0000001000000000
-
1111111111111111
0111111111111111
0011100000011111
0001000000001110
0000000000001100
0000000000001000
0000000000000000
0000000000000000
0000000000000000
>Right
0000000000001111
0000000000000011
0000000000000011
0000000000001111
0000000000000011
0000000000000011
0000000000001111
0000000000000011
0000000000111111
-
0000000000000011
0000111111111111
0000000000000011
0011100000000001
0001110000000001
0000000000000001
0000011100001111
0000000000000011
0000000000111111
>Bottom
0000000000000000
0000000000000000
0000000000000000
0000000000000000
0000000000000010
0000000000000110
0000100000001110
0001111000011110
1111111111111111
-
1000000000000001
1100000000000011
1110000000000011
1111000000000011
1110000000000011
1100000000000001
1000000000000111
1100111111001111
1111111111111111
>Left
1111100000000000
1001000000000000
1001000000000000
1001000000000000
1001000000000000
1000000000000000
1000000000000000
1010000000000000
1111000000000000
-
1111000000000000
1110000110000000
1100011111000000
1000101011000000
1001010101000000
1000101011000000
1000011111000000
1000001100000000
1100000000000000
>Top|Left
1111111111111111
1001101110111011
1100000000000000
1110000000000000
1100000000000000
1000000000000000
1100000000000000
1110000000000000
1100000000000000
-
1111111111111111
1111100000111111
1110000000001111
1110000000000001
1100000000000000
1100000000000000
1000000000000000
1000000000000000
1000000000000000
>Top|Right
1111111111111111
1111111111011111
0111100111111111
0011000000001111
0000000000001111
0000000000000011
0000000000000001
0000000000000001
0000000000000011
-
1111111111111111
0001111111000011
0000001100000111
0000000000001111
0000000000000111
0000000000000011
0000000000000111
0000000000000111
0000000000011111
>Top|Bottom
1111111111111111
0001111111111111
0000011000001111
0000000000000011
0000000000000000
0000000000000000
0000110110010010
1001111110111011
1111111111111111
-
1111111111111111
0000000000111011
0000011000100001
0000001000100001
0000001000010000
0000001000010000
1000100110000010
1100000010000000
1111111111111111
>Right|Left
1100000000000011
1000000000000001
1110000111000011
1100001111110011
1000011111110011
1001111111110111
1000111111100111
1000000111000001
1100000000000011
-
1100000000000010
1100000000000011
1110000000000011
1111100000000010
1111100000000010
1111110000000011
1111111100000011
1100000000000011
1100000000000010
>Right|Bottom
0000000000000011
0000000000000011
0000000000000111
0000000000001111
0000000000011111
0000000001111111
0000000111111111
0011001111111111
1111111111111111
-
1111110000000001
1111111000010011
1100110000011011
1110111000011011
0000000000010011
0001100001110001
0000011111000001
0000001111100011
1111111111111111
>Bottom|Left
1000000000000000
1000000000000000
1100000000000000
1100000000000000
1100000000000000
1000001111110000
1000011111111100
1001111111111101
1111111111111111
-
1100000000000000
1000000000000000
1000000000000000
1000000000000000
1000000000000000
1100000000000000
1110000000000000
1111000000000000
1111111111111111
>Top|Bottom|Left
1111111111111111
1111111111000000
1111110000000000
1111100000000000
1111000000000000
1111000000000000
1111100000000000
1111110000000000
1111111111111111
-
1111111111111111
1000000000100000
1111111110000000
1100000000000000
1111000000000000
1000000000000000
1111100000000000
1111110000000000
1111111111111111
>Top|Right|Left
1111111111111111
1000000000000001
1000011110011001
1010000100001001
1010000101111101
1000000101111101
1010011100001101
1000000000001001
1100000000000011
-
1111111111111111
1000111111111111
1000011111111111
1000001111111111
1000000111000111
1000000110000001
1000000000000001
1000000000000001
1100000000000011
>Top|Bottom|Right
1111111111111111
1110100000011101
1100101110000101
1111101110010001
0000000000010001
1001111111110001
1111000000000001
1110000000000001
1111111111111111
-
1111111111111111
1000000000000001
0000000111000001
0010000100000001
0011111111111001
0000000100001001
0000011100001001
1000000000000001
1111111111111111
>Right|Bottom|Left
1100000000000011
1000000000000001
1000000000000001
1001000000001001
1001100000011001
1001100000011001
1001100110011001
1001100110011001
1111111111111111
-
1100000000111111
1000000000011111
1000000000001111
1000000000000111
1000000000000001
1000000000000001
1110000000000001
1111000000000001
1111111111111111
>Top|Right|Bottom|Left
1111111111111111
1000000000000001
1011111110000001
1001111111000001
1000111111100001
1000011111110001
1000001111111101
1000000000000001
1111111111111111
-
1111111111111111
1100000000000011
1001111111111001
1000000000000101
1011111111111101
1010000000000001
1001111111111001
1100000000000011
1111111111111111
-
1111111111111111
1100000000000011
1000000000000001
1000110000110001
1000000000000001
1001000000001001
1001111111111001
1100000000000011
1111111111111111
>None
1100000000000000
1000000000000000
0000000000000000
0000000000000000
0000000000000000
0000000000000000
0000000000000000
0000000000000001
0000000000000011
-
0000011111111000
0000011111110000
0001111111100000
0001111111000000
0001100111111000
0001110111111000
0000110111111000
0000000000011000
0000000000000000
-
0000000000000000
0000000000000000
0000000000000000
0000000000000000
0000000000000000
0000000000000000
0000000000000000
0000000000000000
0000000000000000
-
0000000000000000
0000000000000000
0000000000000000
0000000000000000
0000000000000000
0000000000000000
0000000000000000
0000000000000000
0000000000000000
