>T
1111111111111111
0110011111100000
0000001111000000
0000000000000000
0000000000000000
0000000000000000
0000000000000000
0000000000000000
0000000000000000
-
1111111111111111
0111111111111111
0011100000011111
0001000000001110
0000000000001100
0000000000001000
0000000000000000
0000000000000000
0000000000000000
>R
0000000000001111
0000000000000011
0000000000000011
0000000000001111
0000000000000011
0000000000000011
0000000000001111
0000000000000011
0000000000111111
-
0000000000000011
0000111111111111
0000000000000011
0011100000000001
0001110000000001
0000000000000001
0000011100001111
0000000000000011
0000000000111111
>B
0000000000000000
0000000000000000
0000000000000000
0000000000000000
0000000000000010
0000000000000110
0000100000001110
0001111000011110
1111111111111111
>L
1111100000000000
1001000000000000
1001000000000000
1001000000000000
1001000000000000
1000000000000000
1000000000000000
1010000000000000
1111000000000000
>TL
>TR
>TB
>RL
>RB
>BL
>TBL
>TRL
>TBR
>RBL
>TRBL